NO           ./path_to_the_north_texture
SO ./path_to_the_south_texture           
WE    ./path_to_the_west_texture
EA           ./path_to_the_east_textture

F 220,255,0
C 225,30,0


     111111                   111   11111        
        10111111111111111111111011111000111111111
        10000000001100000000000000000010000000001
        10110000011100000000000011111100111111101
        1001000000000000000000001   10001     101
111111111011000001110000000000001   11011     101
100000000011000001110111111111111   11011     1011111111
11110111111111011100000010001       11011     101
11110111111111011101010010001       100011  11101
11000000110101011100000010001       110001  10001
10000000000000001100000010001       1101011110111
10000000000000001101010010001       100000000001
1100000111010101111101111000111     111111111111
1111N111 1110101 100000000001
11111111 1111111 111111111111