

NO ./path_to_the_north_texture
F 220, 50 ,0
SO ./path_to_the_south_texture 
WE ./path_to_the_west_texture
EA ./path_to_the_east_textture

C 225,30,0


     111111                   111   11111        
        10111111111111111111111011111000111111111    
        10000000001100000000000000000010000000001
        10110000011100000000000011111100111111101
        1001000000000000000000001   10001     101    
111111111011000001110000000000001   11011     101
100000000011000001110111110111111   11011     101
11110111111111011100000010001       11011     101
11110111111111011101010010001       100011  11101    
11000000110101011100000010001       110001  10001
1000000000000000110000001000111111111101011110111
100000000000000011010100100000000000000000000001
1100N0011101010111110111100011111111111111011111
111111111111111111111111111111111111111111111111
1
111111111111111111111111111111111111111111111111
1111111 1110101 100000000001            101
11111111 1110111 111111111111            101
           101                           101
           101                           101
           101111111111111111111111111111101
           100000000000000000000000000000001
           111111111111111111111111111111111
